壁壁壁壁壁壁壁壁
壁　　　　　　壁
壁　　　　　　壁
壁　　　　　　壁
壁　　　　　　壁
壁　宝　　　　壁
壁　　　　　　壁
壁　　　　　　壁
壁　　　　上　壁
壁　　　　　　壁
壁壁壁壁壁壁壁壁
