ÊÉÊÉÊÉÊÉÊÉÊÉÊÉÊÉ
ÊÉ¡¡¡¡¡¡¡¡¡¡¡¡ÊÉ
ÊÉ¡¡¡¡¡¡¡¡¡¡¡¡ÊÉ
ÊÉ¡¡¡¡¡¡¡¡¡¡¡¡ÊÉ
ÊÉ¡¡¡¡¡¡¡¡¡¡¡¡ÊÉ
ÊÉ¡¡Êõ¡¡¡¡¡¡¡¡ÊÉ
ÊÉ¡¡¡¡¡¡¡¡¡¡¡¡ÊÉ
ÊÉ¡¡¡¡¡¡¡¡¡¡¡¡ÊÉ
ÊÉ¡¡¡¡¡¡¡¡¾å¡¡ÊÉ
ÊÉ¡¡¡¡¡¡¡¡¡¡¡¡ÊÉ
ÊÉÊÉÊÉÊÉÊÉÊÉÊÉÊÉ
